R   1300    900
NO ./textures/muro.xpm
SO ./textures/muro.xpm
WE ./textures/muro.xpm
EA ./textures/muro.xpm

S ./textures/duckwithknife.xpm
F ./textures/lavetta.xpm
C ./textures/cielo.xpm

11111111111111111111111111
10000000001100000002000011
10110000011100002000000011
10010000000000000000200011
111111111011000001110000011
100000000011000001110111111
1111011111111101110000001001
1111011111111101110101001001
11000000110101011100000010011
10000000000000001100000000001
1000N000000000001101010010001
11000001110101011111011000011
11110111 1110101 101111010001
11111111 1111111 111111111111